Note: Most of the commands, listed below, will work; however, some commands such as QuickTime.cpl (requires Quick Time) or gpedit.msc (requires Business, Professional, or Ultimate Windows versions) may not run depending on installed components, Windows versions, Windows editions etc.	
	
Name	Function
Bluetooth Control Panel Applet	bthprops.cpl
Infrared Control Panel Applet	irprops.cpl
Tablet PC Control Panel	TabletPC.cpl
 Accessibility Controls	 access.cpl
Add Hardware Wizard	  hdwwiz.cpl
Add/Remove Programs	 appwiz.cpl
Administrative Tools	 control admintools
Automatic Updates	 wuaucpl.cpl
Bluetooth Transfer wizard	  fsquirt
Calculator	 calc
Certificate Manager	certmgr.msc
Character Map	charmap
Check Disk Utility	chkdsk
Clipboard Viewer	clipbrd
Command Prompt	cmd
Component Services	dcomcnfg
Computer Management	compmgmt.msc
Control Panel	control panel
Date and Time Properties	timedate.cpl
DDE Share	ddeshare
Device Manager	devmgmt.msc
Direct X Control Panel	directx.cpl
Direct X Troubleshooter	dxdiag
Disk Cleanup Utility	cleanmgr
Disk Defragment	dfrg.msc
Disk Management	diskmgmt.msc
Disk Partition Manager	diskpart
Display Properties	control Desktop
Display Properties	desk.cpl
Display Properties	control Color
Display Properties	desk.cpl
Display Properties	control Color
Driver Verifier Utility	verifier
Event Viewer	eventvwr.msc
File Signature Verification Tool	sigverif
Findfast	findfast.cpl
Folders Properties	control Folders
Fonts	control Fonts
Free Cell Card Game	freecell
Game Controllers	joy.cpl
Group Policy Editor	gpedit.msc
iexpress wizard	 iexpress
Indexing Service	 ciadv.msc
Internet Properties	 Inetcpl.cpl
Internet Explorer	iexplore
 IP Configuration(Connection Configuration	ipconfig /all
IP Config (DNS Cache Contents)	ipconfig /displaydns
IP Config (Delete DNS Cache Contents)	 ipconfig/flushdns
IP Config (Release All Connections)	 ipconfig / release
IP Config(Renew All Connections)	ipconfig / renew
IP Config (Refresh DHCP & Re Registers DNS)	ipconfig/registerdns
IP Config (Display DHCP Class ID)	ipconfig/showclassid
IP Config(Modifies DHCP Class ID)	ipconfig/setclassid
Java Control Panel (lflnstalled)	jpicpl32.cpl
Java Control Panel (lflnstalled)	javaws
Keyboard Properties	control keyboard
Keyboard Properties	main.cpl keyboard
Local Security Settings	secpol.msc
Local Users and Groups	lusrmgr.msc
Logs out of windows	logoff
Microsoft Chat	winchat
Minesweeper Game	winmine
Mouse Properties	control mouse
Mouse Properties	main.cpl
Network Connections	control netconnections
Network Connections	ncpa.cpl
Network Setup Wizard	netsetup.cpl
Notepad	notepad
ODBC Data Source Administrator	odbccp32.cpl
On Screen Keyboard	osk
Password Properties	password.cpl
Performance Monitor	perfmon.msc
Performance Monitor	perfmon
Phone and Modem Options	telephon.cpl
Power Management	powercfg.cpl
Printers and Faxes	control printers
Printers Folder	printers
Private Character Editor	eudcedit
Quicktime (lf lnstalled)	QuickTime.cpl
Regional Settings	intl.cpl
Registry Editor	regedit
Registry Editor 32	regedit32
Remote Desktop	mstsc
Removable Storage	ntmsmgr.msc
Removable Storage Operator Requests	ntmsoprq.msc
Resultant Set of Policy	rsop.msc
Scanners and Cameras	sticpl.cpl
Scheduled Tasks	control schedtasks
Security Center	wscui.cpl
Services	services.msc
Shared Folders	fsmgmt.msc
Shuts Down Windows	shutdown
Sounds and Audio	mmsys.cpl
SQL Client Configuration	cliconfg
 System Configuration Editor	 sysedit
  System Configuration Utility	msconfig
 System File Checker(Scan Immediately)	 sfc/scannow
 System FC (Scan Once At Next Boot)	 sfc/scanonce
 System FC (Scan On Every Boot)	 sfc/scanboot
 System FC (Return to Default Setting)	 sfc / revert
 System FC (Purge File Cache)	 sfc/purgecache
System FC (Set Cache Size to size x)	  sfc/cachesize=x
 System Properties	 sysdm.cpl
 Task Manager	 Taskmgr
 User Account Management	 nusrmgr.cpl
Utility Manager	utilman
Windows Explorer	explorer
Windows Firewall	firewall.cpl
Windows Magnifier	magnify
Windows Management lnfrastructure	wmimgmt.msc
Windows System Security Tool	syskey
Windows Update Launches	wupdmgr
Windows Version	winver
Wordpad	Write
Power Options	  powercfg.cpl
Screen Resolution	  desk.cpl
 Share Creation Wizard	 shrpubw
 Sound	 mmsys.cpl
 Sound recorder	 soundrecorder
 Sync Center	 mobsync
 System Restore	rstrui
 Task Scheduler	 taskschd.msc
 Utility Manager	 utilman
 Volume Mixer	 sndvol
 Windows Action Center	 wscui.cpl
Windows DVD Maker	 dvdmaker
 Windows Disc Image Burning Tool	 isoburn
 Windows Easy Transfer	 migwiz
Windows Firewall	firewall.cpl
Windows Features	optionalfeatures
Windows Media Player	wmplayer
Windows Mobility Center	mblctr
Windows Remote Assistance	msra
Windows Repair Disc	recdisc
Windows Update	wuapp
XPS Viewer	xpsrchvw
Windows Action Center	wscui.cpl
User Account Control Settings	useraccountcontrolsettings
System Information	msinfo32
System Properties (Advanced Tab)	systempropertiesadvanced
System Properties (Computer Name Tab)	systempropertiescomputername
System Properties (Hardware Tab)	systempropertieshardware
System Properties (Remote Tab)	systempropertiesremote
System Properties (System Protection Tab)	systempropertiesprotection
Snipping Tool	snippingtool
Set Program Access and Computer Defaults	computerdefaults
Malicious Software Removal Tool	mrt
Manage Your File Encryption Certificates	rekeywiz
Microsoft Management Console	mmc
Microsoft Support Diagnostic Tool	msdt
Narrator	narrator
Device Pairing Wizard	devicepairingwizard
Device Manager	devmgmt.msc
Default Location	locationnotifications
Date and Time	timedate.cpl
Credential Backup and Restore Wizard	credwiz
Create A Shared Folder Wizard	shrpubw
ClearType Tuner	cttune
Color Management	colorcpl
Component Services	comexp.msc
Connect to a Projector	displayswitch
Troubleshooting	control.exe /name Microsoft.Troubleshooting
Add Hardware Wizard	hdwwiz
Advanced User Accounts	netplwiz
Authorization Manager	azman
Backup and Restore	sdclt
Event Viewer	eventvwr
Getting Started	gettingstarted
Performance Monitor	perfmon
Paint	mspaint
Performance Options	systempropertiesperformance
Security Center	wscui.cpl
Microsoft Chat	winchat
Windows Root Drive	%systemdrive%
